+-------------------------------------------+
|                                           |
|                                           |
|                                           |
|                                           |
|+-------+                                  |
|        |                                  |
|        |                =0=               |
|        |                                  |
|        |                                  |
|        |                                  |
|        |                                  |
|+-------+                                  |
|                                           |
|                                           |
+-------------------------------------------+
